- cats = الاقسام 
	- CatID = رقم القسم 
	- CatName = اسم القسم
	- CatMain = رقم القسم الرئيس
- cert = الشهادات
	- CertID = رقم الشهاده 
	- CertTitle = عنوان الشهاده 
	- Certimg = صوره الشهاده
	- Certlink = رابط الشهاده
	- CertUser = رقم المستخدم الخاص بالشهاده
- msgs = الرسائل 
	- masgsID = رقم الرساله 
	- msgsText = تقاصيل الرساله 
	- msgsTime = وقت الارسال 
	- msgsFrom = المرسل 
	- msgsTo = المستقبل
- offers = العروض
	- OffersID = رقم العرض 
	- OffersDed = وضف العرض
	- OffersTime = تاريخ تقديم العرض
	- PriceOffers = السعر المقدم
	- OffersService = رقم الخدمه
	- OffersUser = رقم مقدم العرض
	- OffersNeedTime = الوقت المقدم لانهاء الخدمه 
	- OffersStat = حاله العرض
- portfoilo = الاعمال السابقه
	- PortfoiloID = رقم العمل السابق
	- PortfoiloTitle = عنوان العمل السابق	
	- PortfoiloDes = تفاصيل العمل السابق
	- PortfoiloDate = تاريخ العمل السابق 
	- PortfoiloImg = صوره للعمل السابق
	- PortfoiloUrl = رابط العمل السابق
	- PortfoiloUser = رقم المستخدم صاحب العمل السابق 
- services = الخدمات
	- id_services = رقم الخدمه
	- service_title = عنوان الخدمه 
	- service_des = تفاصيل الخدمه
	- service_time = وقت طلب الخدمه
	- service_needTime = الوقت المتوقع لانجاز الخدمه 
	- service_money = المبلغ المتوقع لتقديم الخدمه
	- user_id = رقم المستخدم الطالب للخدمه
	- offer_id = رقم العرض المقبول
	- sections_services = القسم الخاص بالخدمه
	- services_stat = حاله الخدمه
- skills = المهارات
	- SkillID = رقم المهاره
	- SkillName = اسم المهاره
	- SkillImg = صوره المهاره
- users = المستخدمين
	- User_id = رقم المستخدم
	- User_name = اسم المستخدم
	- User_E-mail = البريد الخاص بالمستخدم
	- User_passowrd = كلمه السر الخاصه بالمستخدم
	- User_phone = رقم الهاتف الخاص بالمستخدم
	- User_paypal = حساب البي بال الخاص بالمستخدم 
	- User_Site = الموقع الالكترونى الخاص بالمستخدم 
	- User_Des = وصف المستخدم
	- User_Img = صوره المستخدم
- user_skill = مهارات المستخدم
	- user_skillID = رقم المهاره
	- userID_skill = رقم المستخدم صاحب المهاره